"Window","Window Begin","Window End","Generations","Run Time","Eval Time","EA Time","Train Size","Train Pos","Train Neg","Test Size","Test Pos","Test Neg","Train Fitness","Test Fitness","Neurons","Connections"
0,"2018-05-30T14:25:28","2018-06-03T14:25:33",750,6.856170475,6.05394165416667,0.531098083333333,152051,52563,99488,38189,13462,24727,0.720319229521069,0.733934646941842,12,11
1,"2018-05-31T14:25:40","2018-06-04T14:25:42",1500,6.80426792916667,6.02648233333333,0.471482516666667,151330,52846,98484,39011,13862,25149,0.729217316005938,0.722921363066543,12,11
2,"2018-06-01T14:25:31","2018-06-05T14:25:40",2250,6.8353034625,6.04311978333333,0.4818649,152865,54183,98682,37827,14462,23365,0.732744125231627,0.738232896512842,12,11
3,"2018-06-02T14:25:40","2018-06-06T14:25:33",3000,6.81808849166667,6.0432402375,0.4741825625,152281,55133,97148,34126,12023,22103,0.736997001134052,0.754507377727353,12,11
4,"2018-06-03T14:25:33","2018-06-07T14:25:36",3750,7.06015122083333,6.29077846666667,0.4774847125,149154,53810,95344,31107,7772,23335,0.744214129766718,0.768880163346174,12,11
5,"2018-06-04T14:25:42","2018-06-08T14:25:33",4500,6.98899644166667,6.23897935,0.481945870833333,142072,48120,93952,30302,7695,22607,0.751841215559517,0.757171590001004,12,11
6,"2018-06-05T14:25:40","2018-06-09T14:25:30",5250,6.77421804583333,6.0287038125,0.4772515625,133363,41953,91410,30205,7684,22521,0.757626047493779,0.75552635632505,12,11
7,"2018-06-06T14:25:33","2018-06-10T14:25:36",6000,6.84595800833333,6.10995274583333,0.473373066666667,125741,35175,90566,29687,7524,22163,0.763164151268793,0.765300417508593,12,11
8,"2018-06-07T14:25:36","2018-06-11T14:25:31",6750,7.1265936,6.37502320833333,0.480566604166667,121302,30676,90626,31565,11424,20141,0.765958980649299,0.738968605322323,12,11
9,"2018-06-08T14:25:33","2018-06-12T14:25:26",7500,6.776891075,6.07662905833333,0.4695004375,121759,34327,87432,30596,8167,22429,0.75753004349716,0.762172150015054,12,11
