"Strategy","Window","Window Begin","Window End","Generations","Run Time","Eval Time","EA Time","Train Size","Train Pos","Train Neg","Test Size","Test Pos","Test Neg","Train Fitness","Test Fitness","Neurons","Connections"
"normal",0,"2018-05-30T14:25:28","2018-06-03T14:25:33",750,7.57620905416667,6.316132825,0.963805008333333,152051,52563,99488,38189,13462,24727,0.743033921506051,0.757803111477858,23,50
"normal",1,"2018-05-31T14:25:40","2018-06-04T14:25:42",1500,8.78026847083333,6.8040638625,1.64822219583333,151330,52846,98484,39011,13862,25149,0.762232500396124,0.758077886312654,26,66
"normal",2,"2018-06-01T14:25:31","2018-06-05T14:25:40",2250,10.0636620833333,7.14556101666667,2.60002699166667,152865,54183,98682,37827,14462,23365,0.771133349596666,0.76932167332244,29,76
"normal",3,"2018-06-02T14:25:40","2018-06-06T14:25:33",3000,10.2556781166667,7.10255703333333,2.81435542916667,152281,55133,97148,34126,12023,22103,0.780207068738656,0.786152325301011,31,82
"normal",4,"2018-06-03T14:25:33","2018-06-07T14:25:36",3750,10.3708755375,7.17192475833333,2.87883705833333,149154,53810,95344,31107,7772,23335,0.792632090975363,0.813692516007698,35,108
"normal",5,"2018-06-04T14:25:42","2018-06-08T14:25:33",4500,11.9406346958333,7.55821575833333,4.0558601,142072,48120,93952,30302,7695,22607,0.804861624874354,0.811222803617354,37,118
"normal",6,"2018-06-05T14:25:40","2018-06-09T14:25:30",5250,12.2004698333333,7.58267724583333,4.32487063333333,133363,41953,91410,30205,7684,22521,0.814624202284983,0.807426728084039,40,128
"normal",7,"2018-06-06T14:25:33","2018-06-10T14:25:36",6000,12.826164075,7.9392156,4.579464475,125741,35175,90566,29687,7524,22163,0.81694377930212,0.817794790191218,43,134
"normal",8,"2018-06-07T14:25:36","2018-06-11T14:25:31",6750,14.6786457416667,8.3580329,6.00025612083333,121302,30676,90626,31565,11424,20141,0.819647417770896,0.796176718012313,45,149
"normal",9,"2018-06-08T14:25:33","2018-06-12T14:25:26",7500,17.0401129875,8.768319675,7.9643662125,121759,34327,87432,30596,8167,22429,0.813019589359209,0.81619514765238,51,168
"flat",0,"2018-05-30T14:25:28","2018-06-03T14:25:33",750,6.856170475,6.05394165416667,0.531098083333333,152051,52563,99488,38189,13462,24727,0.720319229521069,0.733934646941842,12,11
"flat",1,"2018-05-31T14:25:40","2018-06-04T14:25:42",1500,6.80426792916667,6.02648233333333,0.471482516666667,151330,52846,98484,39011,13862,25149,0.729217316005938,0.722921363066543,12,11
"flat",2,"2018-06-01T14:25:31","2018-06-05T14:25:40",2250,6.8353034625,6.04311978333333,0.4818649,152865,54183,98682,37827,14462,23365,0.732744125231627,0.738232896512842,12,11
"flat",3,"2018-06-02T14:25:40","2018-06-06T14:25:33",3000,6.81808849166667,6.0432402375,0.4741825625,152281,55133,97148,34126,12023,22103,0.736997001134052,0.754507377727353,12,11
"flat",4,"2018-06-03T14:25:33","2018-06-07T14:25:36",3750,7.06015122083333,6.29077846666667,0.4774847125,149154,53810,95344,31107,7772,23335,0.744214129766718,0.768880163346174,12,11
"flat",5,"2018-06-04T14:25:42","2018-06-08T14:25:33",4500,6.98899644166667,6.23897935,0.481945870833333,142072,48120,93952,30302,7695,22607,0.751841215559517,0.757171590001004,12,11
"flat",6,"2018-06-05T14:25:40","2018-06-09T14:25:30",5250,6.77421804583333,6.0287038125,0.4772515625,133363,41953,91410,30205,7684,22521,0.757626047493779,0.75552635632505,12,11
"flat",7,"2018-06-06T14:25:33","2018-06-10T14:25:36",6000,6.84595800833333,6.10995274583333,0.473373066666667,125741,35175,90566,29687,7524,22163,0.763164151268793,0.765300417508593,12,11
"flat",8,"2018-06-07T14:25:36","2018-06-11T14:25:31",6750,7.1265936,6.37502320833333,0.480566604166667,121302,30676,90626,31565,11424,20141,0.765958980649299,0.738968605322323,12,11
"flat",9,"2018-06-08T14:25:33","2018-06-12T14:25:26",7500,6.776891075,6.07662905833333,0.4695004375,121759,34327,87432,30596,8167,22429,0.75753004349716,0.762172150015054,12,11
"limited neurons",0,"2018-05-30T14:25:28","2018-06-03T14:25:33",750,7.09504240833333,6.04926315833333,0.736164195833333,152051,52563,99488,38189,13462,24727,0.7444309949031,0.754246546857123,16,28
"limited neurons",1,"2018-05-31T14:25:40","2018-06-04T14:25:42",1500,7.17444932916667,6.19575224166667,0.644905945833333,151330,52846,98484,39011,13862,25149,0.756422377265958,0.756919458340224,17,24
"limited neurons",2,"2018-06-01T14:25:31","2018-06-05T14:25:40",2250,7.08402825,6.09282708333333,0.655930379166667,152865,54183,98682,37827,14462,23365,0.76472038577882,0.771425863933856,16,24
"limited neurons",3,"2018-06-02T14:25:40","2018-06-06T14:25:33",3000,7.3952415375,6.25987993333333,0.791707333333333,152281,55133,97148,34126,12023,22103,0.77160866032488,0.789337176886709,17,27
"limited neurons",4,"2018-06-03T14:25:33","2018-06-07T14:25:36",3750,7.1354686875,6.14538595416667,0.6546721,149154,53810,95344,31107,7772,23335,0.794202983715903,0.815051747737451,17,24
"limited neurons",5,"2018-06-04T14:25:42","2018-06-08T14:25:33",4500,7.11526555833333,6.12496338333333,0.671388466666667,142072,48120,93952,30302,7695,22607,0.802088741575083,0.81106005868044,18,24
"limited neurons",6,"2018-06-05T14:25:40","2018-06-09T14:25:30",5250,7.0837503625,6.1300511875,0.64659595,133363,41953,91410,30205,7684,22521,0.807634122849948,0.800187581878869,18,21
"limited neurons",7,"2018-06-06T14:25:33","2018-06-10T14:25:36",6000,6.98104906666667,6.06925931666667,0.626927641666667,125741,35175,90566,29687,7524,22163,0.809245629291371,0.810839001968955,18,23
"limited neurons",8,"2018-06-07T14:25:36","2018-06-11T14:25:31",6750,7.0455633,6.09832614166667,0.659693908333333,121302,30676,90626,31565,11424,20141,0.813769615308665,0.780144914452549,18,26
"limited neurons",9,"2018-06-08T14:25:33","2018-06-12T14:25:26",7500,6.7546318125,5.87091887916667,0.641070991666667,121759,34327,87432,30596,8167,22429,0.805020281226746,0.805187467664927,18,28
